"filename", "language", "JSON", "Python", "comment", "blank", "total"
"d:\毕业设计\code\data_abstract.ipynb", "JSON", 291, 0, 0, 1, 292
"d:\毕业设计\code\draw statistics.ipynb", "JSON", 179, 0, 0, 1, 180
"d:\毕业设计\code\execute.py", "Python", 0, 6, 0, 0, 6
"d:\毕业设计\code\genim ldaModel.ipynb", "JSON", 550, 0, 0, 1, 551
"d:\毕业设计\code\kmeans.ipynb", "JSON", 392, 0, 0, 1, 393
"d:\毕业设计\code\matt ldaModel - 副本.ipynb", "JSON", 1279, 0, 0, 1, 1280
"d:\毕业设计\code\matt ldaModel.ipynb", "JSON", 1031, 0, 0, 1, 1032
"d:\毕业设计\code\run_lda.ipynb", "JSON", 519, 0, 0, 1, 520
"d:\毕业设计\code\sklearn.ipynb", "JSON", 241, 0, 0, 1, 242
"Total", "-", 4482, 6, 0, 8, 4496