"filename", "language", "Python", "XML", "comment", "blank", "total"
"d:\BertSum-master\BertSum\src\.idea\inspectionProfiles\profiles_settings.xml", "XML", 0, 6, 0, 0, 6
"d:\BertSum-master\BertSum\src\.idea\misc.xml", "XML", 0, 7, 0, 0, 7
"d:\BertSum-master\BertSum\src\.idea\modules.xml", "XML", 0, 8, 0, 0, 8
"d:\BertSum-master\BertSum\src\.idea\src.iml", "XML", 0, 12, 0, 0, 12
"d:\BertSum-master\BertSum\src\distributed.py", "Python", 80, 0, 20, 25, 125
"d:\BertSum-master\BertSum\src\models\__init__.py", "Python", 0, 0, 0, 1, 1
"d:\BertSum-master\BertSum\src\models\data_loader.py", "Python", 178, 0, 16, 45, 239
"d:\BertSum-master\BertSum\src\models\encoder.py", "Python", 102, 0, 2, 31, 135
"d:\BertSum-master\BertSum\src\models\model_builder.py", "Python", 77, 0, 1, 20, 98
"d:\BertSum-master\BertSum\src\models\neural.py", "Python", 113, 0, 93, 33, 239
"d:\BertSum-master\BertSum\src\models\optimizers.py", "Python", 132, 0, 74, 32, 238
"d:\BertSum-master\BertSum\src\models\reporter.py", "Python", 80, 0, 50, 28, 158
"d:\BertSum-master\BertSum\src\models\rnn.py", "Python", 80, 0, 0, 17, 97
"d:\BertSum-master\BertSum\src\models\stats.py", "Python", 53, 0, 51, 17, 121
"d:\BertSum-master\BertSum\src\models\trainer.py", "Python", 254, 0, 105, 71, 430
"d:\BertSum-master\BertSum\src\others\__init__.py", "Python", 0, 0, 0, 1, 1
"d:\BertSum-master\BertSum\src\others\logging.py", "Python", 16, 0, 1, 8, 25
"d:\BertSum-master\BertSum\src\others\pyrouge.py", "Python", 325, 0, 261, 62, 648
"d:\BertSum-master\BertSum\src\others\utils.py", "Python", 89, 0, 0, 14, 103
"d:\BertSum-master\BertSum\src\prepro\__init__.py", "Python", 0, 0, 0, 1, 1
"d:\BertSum-master\BertSum\src\prepro\data_builder.py", "Python", 110, 0, 108, 33, 251
"d:\BertSum-master\BertSum\src\prepro\utils.py", "Python", 12, 0, 16, 7, 35
"d:\BertSum-master\BertSum\src\preprocess.py", "Python", 42, 0, 1, 21, 64
"d:\BertSum-master\BertSum\src\temp.py", "Python", 261, 0, 169, 95, 525
"d:\BertSum-master\BertSum\src\train.py", "Python", 270, 0, 17, 67, 354
"Total", "-", 2274, 33, 985, 629, 3921